5, 4
0, 0; 0, 1; 0, 2; 1, 1;;0, 37, 43
0, 0; 0, 1; 0, 2;;0, 37, 41
1, 0; 1, 1; 0, 1; 0, 2;;0, 37, 45
0, 0;;0, 37, 46
0, 0; 1, 0; 1, 1;;0, 37, 42
0, 0; 1, 0; 2, 0; 2, 1; 2, 2;;0, 37, 44